1111111111
1010001001
1010101011
1000100011
1111111111